12 18 18 18 18 18 18 18 18 18 18 18 18 18 18 18 18 18 18 18 18 18 18 18 18 18 18 18 18 17 20 12 18 18 18 18 18 18 18 18 18 18 18 18 18 18 18 18 18 17 16
11 10 10 10 10 10 10 10 10 10 10 10 10 10 10 10 10 10 10 10 10 10 10 10 10 10 10 10 10 16 20 11 10 10 10 10 10 10 10 10 10 10 10 10 10 10 10 10 10 16 16
11 10 10 10 10 10 10 10 10 10 10 10 10 10 10 10 10 10 10 10 10 10 10 10 10 10 10 10 10 16 20 11 10 10 10 10 10 10 10 10 10 10 10 10 10 10 10 10 10 10 16
11 10 10 10 10 10 10 10 10 10 10 10 10 10 10 10 10 10 10 10 10 10 10 10 10 10 10 10 10 16 20 11 10 10 10 10 10 10 10 10 10 10 10 10 10 10 10 10 10 10 16
11 10 10 10 10 10 10 10 10 10 10 10 10 10 10 10 10 10 10 10 10 10 10 10 10 10 10 10 10 16 20 11 10 10 10 10 10 10 10 10 10 10 10 10 10 10 10 10 10 10 16
11 10 10 10 10 10 10 10 10 10 10 10 10 10 10 10 10 10 10 10 10 10 10 10 10 10 10 10 10 16 20 11 10 10 10 10 10 10 10 10 10 10 10 10 10 10 10 10 10 10 16
11 10 10 10 10 10 10 10 10 10 10 10 10 10 10 10 10 10 10 10 10 10 10 10 10 10 10 10 10 16 20 11 10 10 10 10 10 10 10 10 10 10 10 10 10 10 10 10 10 10 16
11 10 10 10 10 10 10 10 10 10 10 10 10 10 10 10 10 10 10 10 10 10 10 10 10 10 10 10 10 16 20 11 10 10 10 10 10 10 10 10 10 10 10 10 10 10 10 10 10 10 16
11 10 10 10 10 10 10 10 10 10 10 10 10 10 10 10 10 10 10 10 10 10 10 10 10 10 10 10 10 16 20 11 10 10 10 10 10 10 10 10 10 10 10 10 10 10 10 10 10 10 16
11 10 10 10 10 10 10 10 10 10 10 10 10 10 10 10 10 10 10 10 10 10 10 10 10 10 10 10 10 16 20 11 10 10 10 10 10 10 10 10 10 10 10 10 10 10 10 10 10 10 16
11 10 10 10 10 10 10 10 10 10 10 10 10 10 10 10 10 10 10 10 10 10 10 10 10 10 10 10 10 16 20 11 10 10 10 10 10 10 10 10 10 10 10 10 10 10 10 10 10 10 16
11 10 10 10 10 10 10 10 10 10 10 10 10 10 10 10 10 10 10 10 10 10 10 10 10 10 10 10 10 16 20 11 10 10 10 10 10 10 10 10 10 10 10 10 10 10 10 10 10 10 16
11 10 10 10 10 10 10 10 10 10 10 10 10 10 10 10 10 10 10 10 10 10 10 10 10 10 10 10 10 16 20 11 10 10 10 10 10 10 10 10 10 10 10 10 10 10 10 10 10 10 16
11 10 10 10 10 10 10 10 10 10 10 10 10 10 10 10 10 10 10 10 10 10 10 10 10 10 10 10 10 16 20 11 10 10 10 10 10 10 10 10 10 10 10 10 10 10 10 10 10 10 16
11 10 10 10 10 10 10 10 10 10 10 10 10 10 10 10 10 10 10 10 10 10 10 10 10 10 10 10 10 16 20 11 10 10 10 10 10 10 10 10 10 10 10 10 10 10 10 10 10 10 16
11 10 10 10 10 10 10 10 10 10 10 10 10 10 10 10 10 10 10 10 10 10 10 10 10 10 10 10 10 16 20 11 10 10 10 10 10 10 10 10 10 10 10 10 10 10 10 10 10 10 16
11 10 10 10 10 10 10 10 10 10 10 10 10 10 10 10 10 10 10 10 10 10 10 10 10 10 10 10 10 16 20 11 10 10 10 10 10 10 10 10 10 10 10 10 10 10 10 10 10 10 16
11 10 10 10 10 10 10 10 10 10 10 10 10 10 10 10 10 10 10 10 10 10 10 10 10 10 10 10 10 16 20 11 10 10 10 10 10 10 10 10 10 10 10 10 10 10 10 10 10 10 16
11 10 10 10 10 10 10 10 10 10 10 10 10 10 10 10 10 10 10 10 10 10 10 10 10 10 10 10 10 16 20 11 10 10 10 10 10 10 10 10 10 10 10 10 10 10 10 10 10 10 16
11 10 10 10 10 10 10 10 10 10 10 10 10 10 10 10 10 10 10 10 10 10 10 10 10 10 10 10 10 16 20 11 10 10 10 10 10 10 10 10 10 10 10 10 10 10 10 10 10 10 16
11 10 10 10 10 10 10 10 10 10 10 10 10 10 10 10 10 10 10 10 10 10 10 10 10 10 10 10 10 16 20 11 10 10 10 10 10 10 10 10 10 10 10 10 10 10 10 10 10 10 16
11 10 10 10 10 10 10 10 10 10 10 10 10 10 10 10 10 10 10 10 10 10 10 10 10 10 10 10 10 16 20 11 10 10 10 10 10 10 10 10 10 10 10 10 10 10 10 10 10 10 16
11 10 10 10 10 10 10 10 10 10 10 10 10 10 10 10 10 10 10 10 10 10 10 10 10 10 10 10 10 16 20 11 10 10 10 10 10 10 10 10 10 10 10 10 10 10 10 10 10 10 16
11 10 10 10 10 10 10 10 10 10 10 10 10 10 10 10 10 10 10 10 10 10 10 10 10 10 10 10 10 16 20 11 10 10 10 10 10 10 10 10 10 10 10 10 10 10 10 10 10 10 16
11 10 10 10 10 10 10 10 10 10 10 10 10 10 10 10 10 10 10 10 10 10 10 10 10 10 10 10 10 16 20 11 10 10 10 10 10 10 10 10 10 10 10 10 10 10 10 10 10 10 16
11 10 10 10 10 10 10 10 10 10 10 10 10 10 10 10 10 10 10 10 10 10 10 10 10 10 10 10 10 16 20 11 10 10 10 10 10 10 10 10 10 10 10 10 10 10 10 10 10 10 16
11 10 10 10 10 10 10 10 10 10 10 10 10 10 10 10 10 10 10 10 10 10 10 10 10 10 10 10 10 16 20 11 10 10 10 10 10 10 10 10 10 10 10 10 10 10 10 10 10 10 16
11 10 10 10 10 10 10 10 10 10 10 10 10 10 10 10 10 10 10 10 10 10 10 10 10 10 10 10 10 16 20 11 10 10 10 10 10 10 10 10 10 10 10 10 10 10 10 10 10 10 16
11 10 10 10 10 10 10 10 10 10 10 10 10 10 10 10 10 10 10 10 10 10 10 10 10 10 10 10 10 16 20 11 10 10 10 10 10 10 10 10 10 10 10 10 10 10 10 10 10 10 16
11 10 10 10 10 10 10 10 10 10 10 10 10 10 10 10 10 10 10 10 10 10 10 10 10 10 10 10 10 16 20 11 10 10 10 10 10 10 10 10 10 10 10 10 10 10 10 10 10 10 16
11 10 10 10 10 10 10 10 10 10 10 10 10 10 10 10 10 10 10 10 10 10 10 10 10 10 10 10 10 16 20 11 10 10 10 10 10 10 10 10 10 10 10 10 10 10 10 10 10 10 16
11 10 10 10 10 10 10 10 10 10 10 10 10 10 10 10 10 10 10 10 10 10 10 10 10 10 10 10 10 16 20 11 10 10 10 10 10 10 10 10 10 10 10 10 10 10 10 10 10 10 16
11 10 10 10 10 10 10 10 10 10 10 10 10 10 10 10 10 10 10 10 10 10 10 10 10 10 10 10 10 16 20 11 10 10 10 10 10 10 10 10 10 10 10 10 10 10 10 10 10 10 16
13 14 14 14 14 14 14 14 14 14 14 14 14 14 14 14 14 14 14 14 14 14 14 14 14 14 14 14 14 15 20 13 14 14 14 14 14 14 14 14 14 14 14 14 14 14 14 14 14 10 16
20 20 20 20 20 20 20 20 20 20 20 20 20 20 20 20 20 20 20 20 20 20 20 20 20 20 20 20 20 20 20 20 20 20 20 20 20 20 20 20 20 20 20 20 20 20 20 20 20 10 16
12 18 18 18 18 18 18 18 18 18 18 18 18 18 18 18 18 18 18 18 18 18 18 18 18 18 18 18 18 18 18 17 20 12 18 18 18 18 18 18 18 18 18 18 17 20 20 20 20 10 16
11 10 10 10 10 10 10 10 10 10 10 10 10 10 10 10 10 10 10 10 10 10 10 10 10 10 10 10 10 10 10 16 20 11 10 10 10 10 10 10 10 10 10 10 16 20 10 20 20 10 16
11 10 10 10 10 10 10 10 10 10 10 10 10 10 10 10 10 10 10 10 10 10 10 10 10 10 10 10 10 10 10 16 20 11 10 10 10 10 10 10 10 10 10 10 16 20 12 18 18 10 16
11 10 10 10 10 10 10 10 10 10 10 10 10 10 10 10 10 10 10 10 10 10 10 10 10 10 10 10 10 10 10 16 20 11 10 10 10 10 10 10 10 10 10 10 16 20 11 10 10 10 16
11 10 10 10 10 10 10 10 10 10 10 10 10 10 10 10 10 10 10 10 10 10 10 10 10 10 10 10 10 10 10 16 20 11 10 10 10 10 10 10 10 10 10 10 16 20 11 10 10 10 16
11 10 10 10 10 10 10 10 10 10 10 10 10 10 10 10 10 10 10 10 10 10 10 10 10 10 10 10 10 10 10 16 20 11 10 10 10 10 10 10 10 10 10 10 16 20 11 10 10 10 16
11 10 10 10 10 10 10 10 10 10 10 10 10 10 10 10 10 10 10 10 10 10 10 10 10 10 10 10 10 10 10 16 20 11 10 10 10 10 10 10 10 10 10 10 16 20 11 10 10 10 16
11 10 10 10 10 10 10 10 10 10 10 10 10 10 10 10 10 10 10 10 10 10 10 10 10 10 10 10 10 10 10 16 20 11 10 10 10 10 10 10 10 10 10 10 16 20 11 10 10 10 16
11 10 10 10 10 10 10 10 10 10 10 10 10 10 10 10 10 10 10 10 10 10 10 10 10 10 10 10 10 10 10 21 18 23 10 10 10 10 10 10 10 10 10 16 20 11 10 10 10 10 16
11 10 10 10 10 10 10 10 10 10 10 10 10 10 10 10 10 10 10 10 10 10 10 10 10 10 10 10 10 10 10 10 10 10 10 10 10 10 10 10 10 10 10 10 16 20 11 10 10 10 16
11 10 10 10 10 10 10 10 10 10 10 10 10 10 10 10 10 10 10 10 10 10 10 10 10 10 10 10 10 10 10 25 14 22 10 10 10 10 10 10 10 10 10 10 16 20 11 10 10 10 16
11 10 10 10 10 10 10 10 10 10 10 10 10 10 10 10 10 10 10 10 10 10 10 10 10 10 26 10 10 10 10 16 20 11 10 10 10 10 10 10 10 10 10 10 16 20 11 10 10 10 16
11 10 10 10 10 10 10 10 10 10 10 10 10 10 10 10 10 10 10 10 10 10 10 10 10 10 10 10 10 10 10 16 20 11 10 10 10 10 10 10 10 10 10 10 16 20 11 10 10 10 16
11 10 10 10 10 10 10 10 10 10 10 10 10 10 10 10 10 10 10 10 10 10 10 10 10 10 10 10 10 10 10 16 20 11 10 10 10 10 10 10 10 10 10 10 16 20 11 10 10 10 16
13 14 14 14 14 14 14 14 14 14 14 14 14 14 14 14 14 14 14 14 14 14 14 14 14 14 14 14 14 14 14 14 24 14 14 14 14 14 14 14 14 14 14 14 14 14 14 14 14 10 15 