12 18 18 18 18 18 18 18 18 18 18 18 18 18 18 17 20 12 18 18 18 18 18 18 18 18 18 18 17 20 12 18 18 18 18 18 18 18 18 18 18 18 18 18 18 18 18 18 18 17
11 24 24 24 24 24 24 24 24 24 24 24 24 24 24 16 20 11 24 24 24 24 24 24 24 24 24 24 16 20 11 24 24 24 24 24 24 24 24 24 24 24 24 24 24 24 24 24 24 16
11 24 10 50 10 10 10 10 50 10 10 10 10 50 52 21 18 23 10 52 10 10 10 53 10 10 10 24 16 20 11 24 45 52 10 52 10 10 10 52 45 10 52 10 10 10 10 45 24 16
11 24 10 10 10 52 10 10 10 10 10 10 10 10 10 10 10 10 10 10 10 52 53 50 53 10 52 24 16 20 11 24 10 10 10 10 10 10 10 10 10 10 10 10 10 10 10 10 24 16
11 24 10 10 10 10 10 10 52 10 10 10 52 10 10 25 14 22 10 10 10 10 10 53 10 10 10 24 16 20 11 24 10 10 45 10 10 10 26 10 10 10 10 10 52 45 10 10 24 16
11 24 10 10 10 10 10 10 10 10 10 10 10 10 10 16 20 11 10 10 10 10 52 10 10 52 10 24 16 20 11 24 10 10 10 10 10 10 10 10 10 52 10 10 10 10 10 10 26 16
11 24 10 52 10 10 10 10 10 10 10 10 10 10 10 16 20 11 24 10 10 10 10 10 10 10 10 24 16 20 11 24 10 52 26 10 52 10 10 10 10 10 10 10 10 26 10 10 24 16
11 24 10 10 10 10 10 10 10 10 52 10 10 10 10 16 20 11 24 52 10 10 10 53 10 10 10 24 16 20 11 24 10 10 10 10 10 10 10 10 10 10 10 10 10 10 10 10 24 16
11 24 10 50 10 10 10 10 51 10 10 10 10 50 10 16 20 11 24 10 10 10 53 45 53 10 52 24 16 20 11 24 10 10 10 52 10 10 10 52 10 10 10 10 52 10 10 10 24 16
11 24 10 10 10 10 10 10 10 10 10 10 10 10 10 16 20 11 24 10 10 10 10 53 52 10 10 24 16 20 11 24 45 10 10 10 10 52 10 10 49 10 10 10 10 10 10 45 24 16
11 24 10 10 10 10 52 10 10 10 10 10 10 10 10 16 20 11 24 10 52 10 10 10 10 10 10 24 16 20 11 24 10 10 10 10 10 10 10 52 10 10 52 10 10 10 52 10 24 16
11 24 52 10 10 10 10 10 10 10 10 10 10 10 10 16 20 11 24 10 10 10 10 10 10 10 10 24 16 20 11 24 10 52 10 10 10 10 10 10 10 10 10 10 10 10 10 10 24 16
11 24 10 10 10 10 10 10 10 10 10 52 10 10 10 16 20 11 24 10 10 52 10 10 10 10 10 24 16 20 11 10 10 10 26 10 10 10 10 10 10 10 10 10 10 10 10 10 24 16
11 24 10 52 10 10 10 10 10 10 10 10 10 10 10 16 20 11 24 10 10 10 10 53 10 10 52 10 21 18 23 10 10 10 10 10 10 10 10 52 10 10 10 52 10 10 52 10 24 16
11 24 10 10 10 10 10 10 52 10 10 10 10 10 10 16 20 11 24 10 10 10 53 44 53 10 10 10 10 10 10 10 10 10 10 10 10 10 10 10 10 10 10 10 10 10 10 10 24 16
11 24 10 50 10 10 10 10 50 10 10 10 10 50 10 16 20 11 24 10 52 10 10 53 10 10 10 52 25 14 22 10 10 10 10 52 10 26 10 10 10 10 10 52 10 10 10 10 24 16
11 24 10 10 10 10 10 10 10 10 10 10 10 10 10 16 20 11 24 10 10 10 10 10 52 10 10 24 16 20 11 10 10 10 45 10 10 10 10 10 10 10 10 26 10 45 10 10 24 16
13 14 14 22 10 25 14 14 14 14 14 14 14 14 14 15 20 11 24 24 24 24 24 24 24 24 24 24 16 20 11 24 10 10 10 10 10 52 10 52 10 10 10 10 10 10 10 10 26 16
20 20 20 11 10 16 20 20 20 20 20 20 20 20 20 20 20 13 14 14 14 14 14 14 14 14 14 14 15 20 11 24 45 52 10 10 10 10 10 10 45 10 10 52 10 10 10 45 26 16
12 18 18 23 10 21 18 18 18 18 18 18 18 18 18 18 17 20 20 20 20 20 20 20 20 20 20 20 20 20 11 24 10 10 10 10 10 10 10 10 10 10 26 10 10 10 10 10 24 16
11 10 10 10 10 10 24 24 24 24 24 24 24 24 24 24 16 20 12 18 18 18 18 18 18 18 18 18 17 20 13 14 14 14 14 14 14 14 14 14 14 14 14 14 14 22 10 25 14 15
11 10 52 10 10 10 10 10 10 10 10 10 10 10 10 24 16 20 11 24 24 24 24 24 24 24 24 24 16 20 20 20 20 20 20 20 20 20 20 20 20 20 20 20 20 11 10 16 20 20
11 10 10 10 10 10 10 10 10 10 10 10 10 10 10 24 16 20 11 24 10 10 10 10 10 10 52 24 16 20 12 18 18 18 18 18 18 18 18 18 18 18 18 18 18 23 10 21 18 17
11 10 52 10 10 26 52 10 10 10 52 10 10 52 26 24 16 20 11 24 10 52 10 10 10 10 10 24 16 20 11 44 10 10 24 10 10 10 10 10 47 10 24 10 10 10 10 10 44 16
11 10 10 10 10 10 10 10 10 10 10 10 10 10 10 24 16 20 11 24 10 10 10 10 10 52 10 24 16 20 11 10 10 10 52 10 10 52 10 10 10 10 10 10 52 10 10 10 10 16
11 10 10 10 10 10 10 10 10 10 10 10 10 10 10 10 16 20 11 24 10 10 10 44 10 10 10 24 16 20 11 10 27 10 27 10 10 26 10 10 47 10 10 26 10 10 10 52 10 16
11 10 10 10 10 10 10 10 10 52 10 10 10 10 52 10 21 18 23 10 10 10 10 10 10 52 10 24 16 20 11 10 10 10 44 10 10 52 10 10 10 52 10 10 10 44 10 10 10 16
11 24 10 10 10 10 10 10 10 10 10 10 10 10 10 10 10 10 10 10 10 10 10 10 10 10 10 24 16 20 11 10 27 10 27 52 10 10 10 10 47 10 10 10 10 10 10 10 24 16
11 24 10 10 10 10 10 10 10 52 10 10 10 10 10 10 25 14 22 10 10 10 10 10 10 10 10 24 16 20 11 10 10 52 10 10 10 10 10 52 10 10 10 10 52 10 10 10 10 16
11 24 10 10 10 10 52 10 10 10 10 10 10 10 10 10 16 20 11 24 10 10 52 10 10 10 10 24 16 20 11 10 47 10 47 10 47 10 47 10 46 10 47 10 47 10 47 10 47 16
11 24 10 10 10 10 10 10 10 10 10 52 10 10 10 52 16 20 11 24 10 10 10 45 10 52 10 24 16 20 11 24 10 10 10 10 10 10 52 10 10 10 10 10 10 10 10 52 10 16
11 24 10 26 10 10 26 10 10 26 10 10 26 10 52 26 16 20 11 24 10 10 10 10 10 10 10 24 16 20 11 10 27 10 10 10 10 24 10 10 47 10 10 26 10 10 10 10 10 16
11 24 10 10 10 10 10 10 10 10 10 10 10 10 10 10 16 20 11 24 10 10 10 10 10 10 10 24 16 20 11 10 52 10 44 10 52 10 10 10 10 52 10 10 10 44 10 52 24 16
11 24 10 52 10 10 26 10 10 10 26 10 10 52 10 10 16 20 11 24 10 10 10 10 10 10 10 24 16 20 11 10 27 10 27 10 10 10 48 10 48 10 48 10 10 10 10 10 10 16
11 24 10 10 10 10 10 52 10 10 10 10 10 10 10 10 16 20 11 24 10 10 10 10 10 10 10 24 16 20 11 44 10 24 10 10 10 24 10 10 10 10 10 24 10 10 10 10 44 16
11 24 24 24 24 24 24 24 24 24 24 24 24 24 24 10 16 20 11 24 10 10 10 50 10 10 10 24 16 20 13 14 14 14 14 14 14 14 14 14 14 14 14 14 14 14 14 14 14 15
13 14 14 14 14 14 14 14 14 14 14 14 14 14 14 14 15 20 11 24 10 52 10 10 10 10 10 24 16 20 20 20 20 20 20 20 20 20 20 20 20 20 20 20 20 20 20 20 20 20
20 20 20 20 20 20 20 20 20 20 20 20 20 20 20 20 20 20 11 24 10 10 10 10 10 52 10 24 21 18 18 18 18 18 18 18 18 18 18 18 18 18 18 18 18 18 18 18 18 17
12 18 18 18 18 18 18 18 18 18 18 18 18 18 18 18 18 18 23 10 10 10 10 10 10 10 10 24 24 26 24 24 24 24 24 24 24 24 24 10 24 10 10 10 10 10 24 24 24 16
11 10 10 10 10 10 26 10 10 10 10 10 10 10 10 10 10 10 10 10 10 10 10 10 10 10 10 10 10 10 10 10 10 10 10 52 10 10 10 26 10 24 10 24 10 24 10 10 10 16
11 10 24 24 24 24 24 24 24 24 24 24 24 24 24 24 10 10 26 10 10 52 10 10 10 10 10 10 10 10 10 52 10 10 10 10 10 10 10 10 30 37 37 37 37 37 39 10 10 16
11 10 24 10 10 10 10 10 10 10 10 10 52 10 10 52 10 10 10 10 10 10 10 52 10 10 10 10 10 10 10 10 10 52 10 10 10 10 52 10 32 28 28 28 28 28 31 24 52 16
11 10 24 10 53 10 53 26 53 10 53 10 53 10 10 10 10 10 10 10 10 10 10 10 10 10 10 10 10 10 10 10 10 10 10 10 10 10 10 10 32 28 41 38 42 28 31 10 10 16
11 10 24 53 10 10 10 10 10 10 10 10 10 10 10 10 10 10 10 10 52 10 10 10 10 52 10 10 52 10 10 10 10 52 10 10 10 10 52 10 32 28 31 26 32 28 31 24 10 16
11 10 24 53 10 10 10 52 10 10 10 10 10 10 10 10 10 10 10 10 10 10 10 10 10 10 10 10 10 10 10 10 10 10 10 10 10 10 52 10 32 28 40 37 43 28 31 52 10 16
11 26 24 52 53 10 53 10 53 10 53 10 53 10 52 10 10 10 10 10 10 10 10 10 10 10 10 10 10 10 10 10 10 52 10 10 10 10 52 10 32 28 28 28 28 28 31 24 10 16
11 10 24 10 10 10 10 10 52 10 10 10 10 10 10 10 10 10 52 10 10 10 10 10 52 10 10 52 10 10 10 10 10 52 10 10 10 10 10 10 35 38 38 38 38 38 29 10 10 16
11 10 24 24 24 24 24 24 24 24 24 24 24 24 24 24 10 10 10 10 10 10 10 10 10 10 10 10 10 10 10 10 10 10 10 10 10 10 52 10 24 10 24 10 24 10 24 10 10 16
11 10 10 10 10 10 10 10 10 10 10 10 10 10 52 10 10 24 24 24 24 24 10 10 10 52 10 10 10 10 10 24 24 24 24 24 24 24 24 24 10 10 10 10 10 10 10 10 10 16
13 14 14 14 14 14 14 14 14 14 14 14 14 14 14 14 14 14 14 14 14 14 14 14 14 14 14 14 14 14 14 14 14 14 14 14 14 14 14 14 14 14 14 14 14 14 14 14 14 15